9 16
++++++++++++++++
+ @+         ..+
+  +           +
+  +           +
+  +           +
+ #+   #       +
+              +
+              +
++++++++++++++++