8 10
++++++++++
+@      .+
+  +     +
+ #+.+#+ +
+  +++ +++
+  #    .+
+        +
++++++++++