7 10
++++++++++
+@      .+
+  +     +
+ #+.+#+ +
+  +++ +++
+  #    .+
++++++++++