5 10
++++++++++
+@       +
+ #+++#+ +
+ .+.    +
++++++++++
